DEFAULT
4.0,7.0
24,20;29,18;33,18;58,11;12,17;26,20;34,14;
SSSSSSSSSSSSSSSSSSSSSSSSSSSSSSSSSSSWWWWWWWSSSSSSSSSSSSSSSSSSSSSSSSSSSS
SSSSSSSSSSSSSSSSSSSSSSSSSSSSSSSSSSSWHFFFHWSSSSSSSSSSSSSSSSSSSSSSSSSSSS
SSSSSSSSSSSSSSSSSSSSSSSSSSSSSSSSSSSWFFEFFWSSSSSSSSSSSSSSSSSSSSSSSSSSSS
SSSSSSSSSSSSSSSSSSSSSSSSSSSSSSSSSSSWFFFFFWSSSSSSSSSSSSSSSSSSSSSSSSSSSS
SSSSSSSSSSSSSSSSSSSSSSSSSSSSSSSSSSSWFFFFFWSSSSSSSSSSSSSSSSSSSSSSSSSSSS
SSSSSSSSSSSSSSSSSSSSSSSSSSSSSSSSSSSWWFFFWWSSSSSSSSSSSSSSSSSSSSSSSSSSSS
SSSWWWWWWWWSSSSSSSSSSSSSSSSSSSSSSSSSWFFFWSSSSSSSSSSSSSSSSSSSSSSSSSSSSS
SSSWFFFFFFWSSSSSSSSSSSSSSSSSSSSSSSSSWFFFWSSSSSSSSSSSSSSSSSSSSSSSSSSSSS
SSSWEFFFFFWSSSSSSSSSSSSSSSSSSSWWWWWWWFFFWWWWWWWWWWWWWWWWWWWWWSSSSSSSSS
SSSWHHHHFFWSSSSSSSSSSSSSSSSSSSWPPPPPPPFPPPPPPPPPPPPPPPPPPHHHWSSSSSSSSS
SSSWFFFFFFWSSSSSSSSSSSSSSSSSSSWPPPPPPPFPPPPPPPPPPPPPPPPPPFFFWSSSSSSSSS
SSSWFFFFFFWSSSSSSSSSSSSSSSSSSSWPPPFFFFFPPPPPPPPPPPPPFFFFFFFFWSSSSSSSSS
SSSWFFFFHHWSSSSSSSSSSSSSSSSSSSWPPPFPPPPPPPPPPPPPPPPPPPPPPFFFWSSSSSSSSS
SSSWHFFFFFWSSSSSSSSSSSSSSSSSSSWPPPFPPPPPPPPPPPPPPPPPPPPPPHHHWSSSSSSSSS
SSSWHHFFFWWSWWWWWWWWWWWWWWWWWWWWWWDWWWWWWWWWWWWWWWWWWWWWWWWWWSSSSSSSSS
SSSWWWWWFWSSWFFFFFFFFFFHHHWFFFFFFFFFFFWSSSSSSSSSSSSSSSSSSSSSSSSSSSSSSS
SSSSSSSWFWWWWFFFFFFFFFFFHHWFFFFFFFFFFFWSSSSSSSSSSSSSSSSSSSSSSSSSSSSSSS
SSSSSSSWFHFFDFFFFFFFFFFFFFWFFFFFFFFFFHWSSSSSSSSSSSSSSSSSSSSSSSSSSSSSSS
SSSSSSSWFHFWWFFFFFFFFFFFFFWFFFFFFFFFHHWSSSSSSSSSSSSSSSSSSSSSSSSSSSSSSS
SSSSSSSWFFFWWFFFFFFFFFFFFFWFFFFFFFFHHHWSSSSSSSSSSSSSSSSSSSSSSSSSSSSSSS
SSSSSSSWWWWWWHFFFFFFFFFFFFDFFFFFFFHHHHWSSSSSSSSSSSSSSSSSSSSSSSSSSSSSSS
SSSSSSSSSSSSWHHHFFFFFFFFFFWFFFFFFHHHHHWSSSSSSSSSSSSSSSSSSSSSSSSSSSSSSS
SSSSSSSSSSSSWWWWWWWWWWWWWWWWWWWWWWWWWWWSSSSSSSSSSSSSSSSSSSSSSSSSSSSSSS